101 101 101 101 101 101 101 101 101 101 101 101 101 101 101 101 101 101 101 101 101 101 101 101 101 101 101 101 101 101 101 101 101 101 101 101 101 101 101 101 101 101 101 101 101 101 101 101 101 101
101 101 102 103 103 103 103 103 103 103 103 103 103 103 103 103 103 103 103 103 103 103 103 103 103 103 103 103 103 103 103 103 103 103 123 124 125 124 126 127 128 129 130 131 132 131 133 104 101 101
101 101 109 173 260 275 276 275 277 173 173 231 232 173 173 173 173 173 173 173 173 173 173 173 173 173 173 173 173 173 173 173 173 173 261 269 270 269 285 286 287 288 289 305 304 305 306 105 101 101
101 101 109 173 261 269 270 269 271 135 136 233 234 237 238 240 241 242 243 244 238 238 237 136 136 136 136 136 136 136 136 136 136 139 272 273 280 273 290 291 292 293 294 366 367 308 310 105 101 101
101 101 109 173 272 273 280 273 274 144 173 235 236 239 173 245 246 247 248 249 175 176 239 162 164 164 162 135 136 136 136 136 139 140 261 269 270 269 295 296 297 298 299 305 304 305 306 105 101 101
101 101 109 173 261 269 270 269 271 144 173 152 153 239 173 250 251 252 253 254 177 178 239 163 164 164 163 144 148 157 158 148 140 140 272 273 280 273 274 210 179 209 307 366 367 308 310 105 101 101
101 101 109 173 272 273 280 273 274 144 173 154 156 237 238 255 256 257 258 259 238 238 237 164 164 164 164 144 149 159 160 149 140 140 261 269 270 269 271 210 179 209 304 305 304 305 306 105 101 101
101 101 109 173 261 269 270 269 271 144 173 112 113 114 173 180 180 180 147 173 173 150 173 173 173 150 173 143 142 145 146 142 141 140 272 273 280 273 274 210 179 209 307 366 367 308 310 105 101 101
101 101 109 173 272 273 280 273 274 144 173 119 101 115 173 179 179 179 173 173 173 173 173 150 173 173 150 173 173 179 179 173 173 140 261 269 270 269 271 210 179 209 304 305 304 305 306 105 101 101
101 101 109 173 261 269 270 269 271 144 173 118 117 116 173 179 179 179 179 179 179 179 179 179 179 179 179 179 179 179 179 151 173 140 272 273 280 273 274 210 179 209 307 366 367 308 310 105 101 101
101 101 109 173 272 273 280 273 274 144 173 134 173 147 173 179 179 179 179 179 179 179 179 179 179 179 179 179 179 179 179 173 134 140 261 269 270 269 271 210 179 209 304 305 304 305 306 105 101 101
101 101 109 173 261 269 270 269 271 144 173 173 173 173 173 159 160 173 173 173 173 173 173 173 173 173 173 173 173 173 173 173 173 140 272 273 280 273 274 210 179 209 307 366 367 308 310 105 101 101
101 101 109 173 266 267 278 267 268 143 142 142 142 142 142 145 146 142 142 142 142 142 142 142 142 142 142 142 142 142 142 142 142 141 261 269 270 269 271 210 179 209 304 305 304 305 306 105 101 101
101 101 109 173 164 165 166 167 174 173 173 173 173 173 173 179 179 180 180 180 180 180 180 180 180 180 180 161 161 161 161 161 161 161 272 273 280 273 274 210 179 209 307 366 367 308 310 105 101 101
101 101 109 173 166 167 168 169 173 173 173 173 173 173 173 179 179 179 179 179 179 179 179 179 179 179 179 180 151 173 173 173 173 173 261 269 270 269 271 210 179 209 304 305 304 305 306 105 101 101
101 101 109 173 168 169 173 260 275 276 275 276 275 276 275 276 275 276 275 277 173 179 179 179 179 179 179 209 173 173 171 170 171 147 266 267 278 267 268 210 179 209 307 366 367 308 310 105 101 101
101 101 109 173 173 173 173 261 269 270 269 270 269 270 269 270 269 270 269 271 151 181 181 179 179 179 179 209 173 151 172 173 172 173 173 173 173 173 173 210 179 209 304 305 304 305 306 105 101 101
101 101 109 173 173 173 173 266 267 278 267 278 279 280 279 280 267 278 267 268 151 151 151 181 179 179 179 209 173 173 173 173 173 173 173 173 173 173 173 210 179 209 300 301 302 301 303 105 101 101
101 101 109 173 173 237 325 326 327 328 329 237 261 262 261 262 162 162 111 107 107 110 173 174 181 181 181 182 173 147 163 163 163 163 237 362 363 364 237 210 179 209 337 338 339 340 151 105 101 101
101 101 106 107 110 239 330 331 332 333 334 239 266 365 266 365 162 162 196 197 197 198 173 205 215 215 215 215 206 173 111 107 107 110 239 359 360 361 239 210 179 209 341 342 343 344 148 105 101 101
101 101 101 101 109 239 250 251 252 253 254 239 173 173 112 113 114 147 199 200 200 201 173 207 216 216 216 216 208 173 105 101 101 109 239 357 292 358 239 210 179 209 319 292 293 320 149 105 101 101
101 101 101 101 109 239 335 256 257 258 336 239 173 173 119 101 115 173 199 200 200 201 173 207 217 218 216 216 208 173 105 101 101 109 237 355 322 356 237 210 179 209 345 322 258 346 150 105 101 101
101 101 101 101 109 237 227 228 229 230 238 237 173 173 118 117 116 173 202 203 203 204 148 207 223 219 220 221 208 148 105 101 101 109 260 311 180 312 311 211 179 212 180 180 180 184 147 105 101 101
101 101 101 101 109 152 153 173 173 173 173 173 173 173 173 173 173 173 105 101 101 109 149 222 221 216 216 216 208 149 105 101 101 109 261 313 314 315 316 179 179 179 179 179 179 209 147 105 101 101
101 101 101 101 109 154 155 173 173 173 173 183 184 173 173 173 173 173 105 101 101 106 107 122 120 120 120 120 121 107 108 101 101 109 266 317 287 288 318 213 179 214 181 347 348 349 173 105 101 101
101 101 101 101 109 173 173 173 173 173 173 185 182 173 161 173 173 161 105 101 101 101 101 101 101 101 101 101 101 101 101 101 101 109 134 319 292 293 320 210 179 209 237 350 351 352 237 105 101 101
101 101 101 101 109 170 147 173 161 161 161 190 191 173 161 205 206 161 105 101 101 101 101 101 101 101 101 101 101 101 101 101 101 109 150 321 322 323 324 210 179 209 239 353 292 354 239 105 101 101
101 101 101 101 106 107 107 107 107 107 107 192 193 110 173 207 208 173 105 101 101 102 103 281 282 103 104 101 101 101 101 101 101 109 173 183 180 180 180 211 179 209 237 355 322 356 237 105 101 101
101 101 101 101 101 102 103 104 101 101 101 192 193 109 173 207 208 173 105 101 101 109 162 283 284 162 105 101 101 101 101 101 101 109 173 210 179 179 179 179 179 212 180 180 180 184 227 105 101 101
101 101 101 101 101 109 134 105 101 101 101 192 193 106 107 122 121 107 108 101 101 106 107 107 107 107 108 101 101 101 101 101 101 109 173 185 181 181 181 181 181 181 181 181 181 182 173 105 101 101
101 101 101 101 101 106 107 108 101 101 101 192 193 101 101 101 102 103 104 101 101 101 101 101 101 101 101 101 101 102 103 104 101 109 173 161 161 161 161 205 215 206 161 161 161 161 173 105 101 101
101 101 101 101 101 101 101 101 102 103 103 194 195 186 187 104 109 163 105 101 101 101 101 101 101 101 101 101 101 109 134 105 101 106 107 107 107 110 173 207 216 224 173 111 107 107 107 108 101 101
101 101 101 101 101 101 101 101 109 151 173 173 173 188 189 105 109 173 105 101 101 101 101 101 101 101 101 101 101 106 107 108 101 101 101 101 101 109 173 222 216 208 173 105 101 101 101 101 101 101
101 101 101 101 101 101 101 101 109 173 173 173 173 173 173 105 106 107 108 101 101 101 101 101 101 101 101 101 101 101 101 101 101 101 101 101 101 106 107 122 120 121 107 108 101 101 101 101 101 101
101 101 101 101 101 101 101 101 109 173 173 173 173 173 173 105 101 101 101 101 101 101 101 101 101 101 101 101 101 101 101 101 101 101 101 101 101 101 101 101 101 101 101 101 101 101 101 101 101 101
101 101 101 101 101 101 101 101 109 173 173 173 173 173 173 105 101 101 101 101 101 101 101 101 101 101 101 101 101 101 101 101 101 101 101 101 101 101 101 101 101 101 101 101 101 101 101 101 101 101
101 101 101 101 101 101 101 101 106 107 107 107 107 107 107 108 101 101 101 101 101 101 101 101 101 101 101 101 101 101 101 101 101 101 101 101 101 101 101 101 101 101 101 101 101 101 101 101 101 101
101 101 101 101 101 101 101 101 101 101 101 101 101 101 101 101 101 101 101 101 101 101 101 101 101 101 101 101 101 101 101 101 101 101 101 101 101 101 101 101 101 101 101 101 101 101 101 101 101 101