101 102 103 101 102 103 101 102 103 101 102 103 101 102 103 101 102 103 101 102 103 101 102 103 101 102 103 101 102 103 101 102 103 101 102 103 101 102 103 101 102 103 101 102 103
104 118 109 110 108 109 110 108 109 110 108 109 110 108 109 110 108 109 110 108 109 130 131 132 133 134 135 110 108 109 110 108 109 110 108 109 110 108 109 110 108 109 110 119 106
105 112 185 185 185 185 185 185 185 271 272 185 185 185 185 185 185 185 185 185 185 273 276 279 282 285 288 185 185 185 185 185 418 419 420 421 419 420 421 419 420 421 422 115 107
101 113 185 297 298 299 300 185 185 301 302 303 185 185 185 185 185 185 306 307 185 274 277 280 283 286 289 185 185 185 185 185 431 436 436 436 441 436 436 436 436 436 423 116 103
104 114 185 185 185 185 185 185 185 304 305 185 185 308 185 185 185 185 185 185 185 275 278 281 284 287 290 185 185 185 185 185 435 436 436 436 442 436 436 440 436 436 424 117 106
105 112 185 185 185 185 185 185 185 185 185 185 185 309 311 312 313 314 185 185 185 291 292 293 294 295 296 185 185 185 185 185 432 437 438 439 443 444 436 436 436 436 425 115 107
101 113 185 185 190 191 185 185 185 198 190 191 198 185 185 185 185 185 185 185 185 185 185 185 310 185 185 185 185 310 185 185 434 436 436 436 436 436 440 436 441 436 423 116 103
104 114 185 185 192 193 202 203 185 199 200 193 199 201 185 185 185 308 185 185 185 185 209 185 185 185 185 185 185 185 185 185 433 436 436 436 440 436 436 436 442 436 424 117 106
105 112 185 195 196 197 204 205 191 214 215 228 216 217 218 185 185 309 185 208 191 195 196 197 185 185 185 185 185 185 185 185 432 436 436 441 436 436 436 436 436 436 425 115 107
101 113 186 187 222 223 224 194 193 229 230 231 219 220 221 185 185 185 198 194 193 235 236 237 210 211 185 210 211 185 185 310 431 436 436 442 443 444 436 440 436 436 423 116 103
104 114 188 189 225 226 227 185 185 232 233 234 185 185 185 185 185 185 199 201 185 238 239 240 212 213 185 212 213 185 185 185 433 436 436 436 440 436 441 436 436 436 424 117 106
105 112 185 315 252 253 254 185 185 327 328 329 185 334 335 336 185 185 206 207 185 241 242 243 210 211 244 245 246 186 187 185 432 436 436 436 436 436 442 436 436 436 425 115 107
101 113 185 316 255 256 257 324 325 326 330 315 185 337 338 339 185 185 185 185 185 327 367 185 212 213 247 248 249 188 189 185 431 436 436 436 436 436 436 436 436 436 423 116 103
104 114 308 185 185 317 318 319 320 331 332 316 185 340 341 342 185 185 374 373 373 372 367 185 393 394 250 251 185 185 185 185 430 429 428 427 429 428 427 429 428 427 426 117 106
105 112 309 185 185 185 321 322 323 333 185 185 343 344 345 185 185 185 327 371 370 370 369 185 395 396 185 333 185 185 185 185 185 185 185 185 185 185 185 185 185 185 185 115 107
101 113 185 185 308 185 185 185 185 350 351 185 346 347 348 185 185 185 327 367 185 185 185 185 397 398 185 333 185 185 308 185 185 185 185 308 185 185 185 185 185 185 185 116 103
104 114 185 185 309 185 185 185 185 352 353 354 110 349 109 185 185 375 376 377 185 388 389 185 185 185 185 333 185 185 309 185 185 185 185 309 185 185 185 185 185 185 185 117 106
105 112 185 185 185 185 185 306 307 355 356 357 185 185 185 185 185 378 379 380 390 391 392 390 390 390 390 333 185 185 185 185 185 185 185 185 185 185 185 306 307 185 185 115 107
101 113 139 140 141 142 140 141 142 140 141 143 350 324 324 324 324 381 382 383 386 185 185 185 185 185 185 185 185 185 185 185 185 185 185 185 185 185 185 185 185 185 185 116 103
104 114 138 149 163 164 165 166 164 167 150 144 352 184 363 352 368 365 384 385 387 185 258 259 260 185 185 185 308 185 185 185 306 307 185 185 185 445 446 447 448 446 447 449 106
105 112 137 153 184 184 172 173 184 174 154 145 327 184 362 327 367 185 185 185 185 261 262 263 264 265 185 185 309 185 185 185 185 185 185 185 185 454 463 465 465 465 466 450 107
101 113 136 155 175 176 184 175 176 184 158 146 327 184 362 327 366 324 324 324 324 266 267 268 269 270 185 185 185 185 185 185 185 185 185 310 185 454 464 338 338 338 468 451 103
104 114 138 155 177 178 184 177 178 184 159 144 327 184 362 364 365 365 365 365 365 365 365 365 185 185 185 185 185 185 185 185 185 185 185 185 185 454 464 469 338 338 467 452 106
105 112 137 156 179 184 184 184 184 184 160 147 358 184 362 185 185 185 185 185 185 185 185 185 185 414 415 185 185 185 306 307 185 185 185 185 185 454 464 470 338 338 467 450 107
101 113 136 155 184 180 184 184 180 184 161 148 359 360 361 185 399 185 185 405 185 185 185 185 185 185 185 416 417 185 185 185 185 185 185 185 185 454 464 338 338 338 467 451 103
104 114 138 155 184 181 184 184 181 184 159 144 185 185 185 185 400 401 403 406 185 185 408 410 412 185 185 185 185 185 185 185 185 185 185 185 185 454 458 459 460 461 462 453 106
105 112 137 157 184 184 182 179 184 183 162 145 185 185 185 185 185 402 404 185 185 407 409 411 413 185 185 185 185 185 185 185 185 185 185 185 185 185 455 455 456 457 455 115 107
101 113 136 151 168 169 170 168 169 171 152 146 185 185 185 185 185 185 185 185 185 185 185 185 185 185 185 185 185 185 185 185 185 185 185 185 185 185 185 185 185 185 185 116 103
104 120 122 123 124 125 123 124 125 123 124 126 127 128 129 127 128 129 127 128 129 127 128 129 127 128 129 127 128 129 127 128 129 127 128 129 127 128 129 127 128 129 127 121 106
105 111 107 105 111 107 105 111 107 105 111 107 105 111 107 105 111 107 105 111 107 105 111 107 105 111 107 105 111 107 105 111 107 105 111 107 105 111 107 105 111 107 105 111 107