44 44 44 44 44 44 44 44 11 13 13 13 13 13 13 13 13 13 13 13 13 13 13 13 13 13 13 13 13 13 13 13 13 13 13 13 13 13 13 13 13 13 13 13 13 13 13 13 13 13 13 13 13 13 13 13 13 15 44 44 44 44 44 44 44 44
44 44 44 44 44 44 44 44 10 12 14 14 14 14 14 14 14 14 14 14 14 14 14 14 14 14 14 14 14 14 14 14 14 14 14 14 14 14 14 14 14 14 14 14 14 14 14 14 14 14 14 14 14 14 14 14 17 16 44 44 44 44 44 44 44 44
44 44 44 44 44 44 44 44 10 18 32 32 32 32 32 32 32 32 32 32 32 32 32 32 32 32 32 32 32 32 32 32 32 32 32 32 32 32 32 32 32 32 32 32 32 32 32 32 32 32 32 32 32 32 32 32 19 16 44 44 44 44 44 44 44 44
44 44 44 44 44 44 44 44 10 18 32 32 32 32 32 32 32 32 32 32 32 32 32 32 32 32 32 32 32 32 32 32 32 32 32 32 32 32 32 32 32 32 32 32 32 32 32 32 32 32 32 32 32 32 32 32 19 16 44 44 44 44 44 44 44 44
44 44 44 44 44 44 44 44 10 18 32 32 32 32 32 32 32 32 32 32 32 32 32 32 32 32 32 32 32 32 32 32 32 32 32 32 32 32 32 32 32 32 32 68 69 69 68 32 32 32 32 32 32 32 32 32 19 16 44 44 44 44 44 44 44 44
44 44 44 44 44 44 44 44 10 18 32 32 32 32 32 32 32 32 32 32 32 32 32 32 32 32 32 32 32 32 48 48 48 67 32 32 32 32 32 32 32 32 32 69 69 69 69 32 32 32 32 32 32 32 32 32 19 16 44 44 44 44 44 44 44 44
44 44 44 44 44 44 44 44 10 18 32 32 32 32 32 32 32 32 32 32 32 32 32 32 32 32 32 32 32 32 32 32 32 32 32 32 32 32 32 32 32 32 32 69 69 69 69 32 32 32 32 32 32 32 32 32 19 16 44 44 44 44 44 44 44 44
44 44 44 44 44 44 44 44 10 18 32 32 32 32 32 32 32 32 32 32 32 32 32 32 32 32 32 32 32 32 32 32 32 32 32 32 32 32 32 32 32 32 32 68 69 69 68 32 32 32 32 32 32 32 32 32 19 16 44 44 44 44 44 44 44 44
44 44 44 44 44 44 44 44 10 18 32 32 32 32 32 32 32 32 32 32 32 32 32 32 32 32 32 32 32 32 32 32 32 32 32 32 32 32 32 32 32 32 32 32 32 32 32 32 32 32 32 32 32 32 32 32 19 16 44 44 44 44 44 44 44 44
44 44 44 44 44 44 44 44 10 18 32 32 32 32 32 32 32 32 32 32 70 23 23 23 23 55 32 32 32 32 32 32 32 32 32 32 32 32 32 32 32 32 32 32 32 32 32 32 48 48 48 66 32 32 32 32 19 16 44 44 44 44 44 44 44 44
44 44 44 44 44 44 44 44 10 18 32 32 32 32 32 32 32 32 32 32 19 42 20 49 41 18 32 32 32 32 32 32 32 32 32 32 32 32 32 32 32 32 32 32 32 32 32 32 32 32 32 32 32 32 32 32 19 16 44 44 44 44 44 44 44 44
44 44 44 44 44 44 44 44 10 18 32 32 32 32 32 32 32 32 32 32 19 20 44 44 49 18 32 32 32 32 32 32 32 32 32 32 32 32 32 32 32 32 32 32 32 32 32 32 32 32 32 32 32 32 32 32 19 16 44 44 44 44 44 44 44 44
44 44 44 44 44 44 44 44 10 18 32 32 32 32 48 48 48 32 32 32 19 15 44 44 11 18 32 32 32 32 32 32 32 32 65 32 32 32 32 32 32 32 32 32 32 32 32 32 32 32 32 32 32 32 32 32 19 16 44 44 44 44 44 44 44 44
44 44 44 44 44 44 44 44 10 18 32 32 32 32 32 32 32 32 32 32 19 62 15 11 36 18 32 32 32 32 32 32 32 32 48 32 32 32 32 32 32 32 32 32 32 32 32 32 32 32 32 32 32 32 32 32 19 16 44 44 44 44 44 44 44 44
44 44 44 44 44 44 44 44 10 18 32 32 32 32 32 32 32 32 32 32 71 17 16 10 12 35 32 32 32 32 32 32 32 32 32 32 32 32 32 32 32 32 32 32 32 32 32 32 32 32 32 32 32 32 32 32 19 16 44 44 44 44 44 44 44 44
44 44 44 44 44 44 44 44 10 34 23 23 23 23 23 23 23 23 23 23 23 22 16 10 18 32 32 32 32 32 32 32 32 32 32 32 32 70 23 23 23 23 23 23 23 23 23 23 23 23 23 23 23 23 55 32 19 16 44 44 44 44 44 44 44 44
44 44 44 44 44 44 44 44 49 21 21 21 21 21 21 21 21 21 21 21 21 21 16 10 18 32 32 32 32 32 32 32 32 32 32 32 32 19 42 21 21 21 21 21 21 21 21 21 21 21 21 21 21 41 18 32 19 16 44 44 44 44 44 44 44 44
44 44 44 44 44 44 44 44 44 44 11 61 37 37 37 37 37 37 37 15 44 44 16 10 18 32 32 32 32 32 32 32 32 32 32 32 32 19 16 44 44 44 44 44 44 44 44 44 44 44 44 44 44 10 18 32 19 16 44 44 44 44 44 44 44 44
44 44 44 44 44 44 44 44 44 11 59 60 14 14 14 14 14 81 80 62 15 11 16 10 34 23 23 23 23 55 32 32 32 32 32 32 32 19 16 44 44 44 44 44 44 44 44 44 44 44 44 44 44 10 18 32 19 16 44 44 44 44 44 44 44 44
44 44 44 44 44 44 44 44 44 10 12 35 32 32 32 32 32 19 47 52 52 52 52 52 52 52 64 21 41 18 32 32 32 32 32 32 32 19 16 44 44 44 44 44 44 44 44 44 44 44 44 44 44 10 18 32 19 16 44 44 44 44 44 44 44 44
44 44 44 44 44 44 44 44 44 10 18 32 33 32 32 32 32 71 14 14 14 14 14 14 14 17 16 44 10 18 32 32 32 32 32 48 32 19 16 44 44 44 44 44 44 44 44 44 44 44 44 44 44 10 18 32 19 16 44 44 44 44 44 44 44 44
44 44 44 44 44 44 44 44 44 10 18 32 32 32 32 32 32 32 70 23 55 32 32 32 32 19 16 44 10 18 32 32 32 32 32 32 32 19 16 44 44 44 44 44 44 44 44 44 44 44 44 44 44 10 18 32 19 16 44 44 44 44 44 44 44 44
44 44 44 44 44 44 44 44 44 10 18 32 32 32 32 33 32 32 19 82 18 32 32 32 32 19 16 44 10 18 32 32 32 32 32 32 32 19 16 44 44 44 44 44 44 44 44 44 44 44 44 44 44 10 18 32 19 16 44 44 44 44 44 44 44 44
44 44 44 44 44 44 44 44 44 10 18 32 32 32 32 32 32 32 19 39 18 32 32 32 32 19 16 44 10 18 32 32 32 32 32 32 32 19 16 44 44 44 44 44 44 44 44 44 44 44 44 44 44 10 18 32 19 16 44 44 44 44 44 44 44 44
44 44 44 44 44 44 44 44 44 10 34 23 23 23 55 32 32 32 19 39 18 32 32 32 32 19 16 44 10 18 32 32 32 32 32 32 32 19 16 44 44 44 44 44 44 44 44 44 44 44 44 44 44 10 18 32 19 16 44 44 44 44 44 44 44 44
44 44 44 44 44 44 44 44 44 51 52 52 52 53 18 32 32 32 19 39 78 23 23 23 55 19 16 44 10 18 32 32 32 32 32 32 32 19 16 44 44 44 44 44 44 44 44 44 44 44 44 44 44 10 18 32 19 16 44 44 44 44 44 44 44 44
44 44 44 44 44 44 44 44 44 10 12 14 14 14 35 70 23 23 22 39 79 42 21 41 18 19 16 44 10 18 32 48 32 32 32 32 32 19 16 44 44 44 44 44 44 44 44 44 44 44 44 44 44 10 18 32 19 16 44 44 44 44 44 44 44 44
44 44 44 44 44 44 44 44 44 10 18 32 32 32 32 19 47 52 52 46 52 43 44 10 18 19 62 37 36 18 32 32 32 32 32 32 32 19 16 44 44 44 44 44 44 44 44 44 44 44 44 44 44 10 18 32 19 16 44 44 44 44 44 44 44 44
44 44 44 44 44 44 44 44 44 10 18 32 32 32 32 71 14 14 14 72 73 38 37 36 18 71 14 14 14 35 32 32 32 32 32 32 32 19 16 44 44 44 44 44 44 44 44 44 44 44 44 44 44 10 18 32 19 16 44 44 44 44 44 44 44 44
44 44 44 44 44 44 44 44 44 10 18 32 33 32 32 32 32 32 32 75 74 39 12 14 35 32 32 32 32 32 32 32 32 32 32 32 32 19 16 44 44 44 44 44 44 44 44 44 44 44 44 44 44 10 18 32 19 16 44 44 44 44 44 44 44 44
44 44 44 44 44 44 44 44 44 10 18 32 32 32 32 32 32 32 32 75 74 39 18 32 32 32 32 32 32 32 32 32 32 32 32 32 32 19 62 37 37 37 37 37 37 37 37 37 37 37 37 37 37 36 18 32 19 16 44 44 44 44 44 44 44 44
44 44 44 44 44 44 44 44 44 10 34 55 32 32 32 32 33 32 32 75 74 39 18 32 32 32 33 32 32 32 32 32 32 32 32 32 32 71 14 14 14 14 14 14 14 14 14 14 14 14 14 14 14 14 35 32 19 16 44 44 44 44 44 44 44 44
44 44 44 44 44 44 44 44 44 49 50 34 55 32 32 32 32 32 32 75 74 39 18 32 32 32 33 32 32 32 32 32 32 32 32 32 32 32 32 32 32 32 32 32 32 32 32 32 32 32 32 32 32 32 32 32 19 16 44 44 44 44 44 44 44 44
44 44 44 44 44 44 44 44 44 44 49 50 34 23 23 23 23 23 23 77 76 39 34 23 23 23 23 23 23 23 23 23 23 23 23 23 23 23 23 23 23 23 23 23 23 23 23 23 23 23 23 23 23 23 23 23 22 16 44 44 44 44 44 44 44 44
44 44 44 44 44 44 44 44 44 44 44 49 21 21 21 21 21 21 21 21 21 40 21 21 21 21 21 21 21 21 21 21 21 21 21 21 21 21 21 21 21 21 21 21 21 21 21 21 21 21 21 21 21 21 21 21 21 20 44 44 44 44 44 44 44 44