10 10 10 10 10 10 10 10 10 10 10 10 10 10 10 10 10 10 10 10 10 10 10 10 10 10 10 10 10 10 10 10 10 10 10 10 10 10 10 10 10 10 10 10 10 10 10 10 10 10 10 10 10 10 10 10 10 10 10 10 10 10 10 12 13 13 13 15 10
10 10 10 10 10 10 10 10 10 10 10 10 10 10 10 10 10 10 10 10 10 10 10 10 10 11 11 11 11 11 11 11 11 11 11 11 11 11 11 11 11 11 11 11 11 11 11 11 11 11 11 11 11 11 11 11 11 11 11 11 11 11 12 18 20 21 20 19 11
11 11 11 11 11 11 11 11 11 11 11 11 11 11 11 11 11 11 11 11 11 11 11 11 11 11 11 11 11 11 11 11 11 11 11 11 11 11 11 11 11 11 11 11 11 11 11 11 11 11 11 11 11 11 11 11 11 11 11 11 11 11 16 20 11 87 11 37 11
11 11 11 11 11 11 11 11 11 11 11 11 11 11 11 11 11 11 11 11 11 11 11 11 11 11 11 11 11 11 11 11 11 11 11 11 11 11 11 11 11 11 11 11 11 11 11 11 11 11 11 11 11 11 11 11 11 11 11 11 11 11 16 11 11 11 11 16 11
11 11 11 11 11 11 11 11 11 11 11 11 11 11 11 11 11 11 11 11 11 11 11 11 11 11 11 11 11 11 11 11 11 11 11 11 11 11 11 11 11 11 11 11 11 11 11 11 11 11 11 11 11 11 11 11 11 11 11 11 11 11 16 11 11 11 11 16 11
11 11 11 11 11 11 11 11 11 11 11 11 11 11 11 11 11 11 11 11 11 11 11 11 11 11 11 11 11 11 11 11 11 11 11 11 11 11 11 11 11 11 11 11 11 11 11 11 11 11 11 11 11 11 11 11 11 11 11 11 11 11 16 11 11 11 30 16 11
11 11 11 11 11 11 11 11 11 11 11 11 11 11 11 11 11 11 11 11 11 11 12 13 13 13 13 13 13 13 13 13 13 13 13 13 13 14 11 11 11 11 11 11 11 11 11 11 11 11 11 11 11 11 11 11 11 11 11 11 11 11 16 11 11 11 11 16 11
11 11 11 11 11 11 11 11 11 11 11 11 11 11 11 11 11 11 11 11 11 11 16 20 23 20 20 25 20 20 24 20 20 24 20 20 20 37 11 11 11 11 11 11 11 11 11 11 11 11 11 13 13 13 13 13 14 11 11 11 11 11 16 11 11 11 11 16 11
11 11 11 11 11 11 11 11 11 11 11 11 11 11 11 11 11 11 11 11 11 11 16 11 11 54 11 11 11 11 11 11 11 11 11 31 32 16 13 13 13 13 13 13 13 13 13 13 13 68 13 36 21 20 58 22 37 13 13 13 13 13 18 11 11 11 11 16 11
11 11 11 11 11 11 11 11 11 11 11 11 11 11 11 11 11 11 11 11 11 11 16 11 11 55 11 11 11 11 11 11 11 11 11 31 31 34 20 58 20 20 20 20 20 40 21 20 20 69 20 35 11 11 11 11 34 86 86 86 86 86 79 11 11 11 11 16 11
11 11 11 11 11 11 11 11 11 11 11 11 11 11 11 11 11 11 11 11 11 11 16 11 11 11 11 11 11 11 11 11 11 11 11 11 11 11 11 11 11 11 11 11 11 41 11 11 11 70 11 11 11 11 11 11 11 11 11 11 11 11 11 11 11 11 11 16 11
12 13 13 13 13 13 13 13 13 13 13 13 13 13 13 13 13 13 13 13 13 14 16 11 11 11 11 11 11 11 11 11 11 11 11 11 11 11 11 11 11 11 11 11 11 11 11 11 11 11 11 11 11 11 11 11 11 11 11 11 11 11 11 11 11 11 11 16 11
16 20 20 20 20 20 20 22 20 20 20 20 21 20 20 20 20 26 27 20 20 37 16 11 11 11 11 11 11 11 11 11 11 11 11 11 11 12 13 13 13 13 13 13 13 13 13 13 13 13 13 15 11 11 11 11 12 13 13 13 13 13 13 13 13 13 13 18 11
16 11 38 11 11 11 11 11 11 11 11 11 11 11 11 11 11 28 29 11 38 16 18 11 11 11 11 11 11 11 11 11 11 11 11 11 11 16 57 20 20 20 20 20 20 20 20 22 20 20 20 17 11 11 11 11 16 86 86 86 86 86 86 86 86 86 86 86 11
16 11 32 11 11 11 11 11 11 11 11 11 11 11 11 11 11 11 11 11 32 34 20 11 11 11 11 11 11 11 11 11 11 11 11 11 11 16 11 11 11 11 11 11 11 11 11 11 11 11 11 17 11 11 11 11 16 11 11 11 11 11 11 11 11 11 11 11 11
16 11 11 11 11 11 11 11 11 11 11 11 11 11 11 11 11 11 11 11 11 11 11 11 11 11 11 11 11 11 11 11 11 11 11 11 11 16 11 11 11 11 11 11 11 11 11 11 11 11 11 17 11 11 11 11 16 11 11 11 11 11 11 11 11 11 11 11 11
16 11 11 11 11 11 11 11 11 11 11 11 11 11 11 11 11 11 11 11 11 11 11 11 11 11 11 11 11 11 11 11 11 11 11 11 11 16 11 11 11 11 11 11 11 11 11 11 11 11 11 19 14 11 11 13 18 11 11 11 11 11 11 11 11 11 11 11 11
16 11 38 11 11 11 11 11 11 11 11 11 11 11 11 11 11 11 11 11 38 12 14 11 11 11 11 11 11 11 11 11 11 11 11 11 11 16 11 11 11 11 11 11 11 11 11 11 11 11 11 20 37 11 11 36 78 11 11 11 11 11 11 11 11 11 11 11 11
16 11 32 11 11 11 11 11 11 11 11 11 11 11 11 11 11 11 11 11 32 16 37 11 11 11 11 11 11 11 11 11 11 11 11 11 11 16 11 11 11 11 11 11 11 11 11 11 11 11 11 11 16 82 83 17 11 11 11 11 11 11 11 11 11 11 11 11 11
16 13 13 13 13 13 13 15 11 11 12 13 13 13 13 13 13 13 13 13 13 18 16 11 11 11 11 11 11 11 11 11 11 11 11 11 11 16 11 11 11 11 11 11 11 11 11 11 11 11 11 11 16 82 83 17 11 11 11 11 11 11 11 11 11 11 11 11 11
34 20 20 21 20 20 20 17 11 11 16 20 20 20 22 20 20 20 21 20 20 20 16 11 11 11 11 11 11 11 11 11 11 11 11 11 11 16 11 11 11 11 11 11 11 11 11 11 11 11 11 11 16 82 83 17 11 11 11 11 11 11 11 11 11 11 11 11 11
11 11 11 11 11 11 11 17 11 11 16 11 11 11 11 11 11 11 11 11 11 11 16 11 11 11 11 11 11 11 11 11 11 11 11 59 60 16 11 11 11 11 11 11 11 11 11 11 11 11 11 11 16 84 85 17 11 11 11 11 11 11 11 11 11 11 11 11 11
11 11 11 11 11 11 11 17 11 11 16 11 11 11 11 11 11 11 11 11 11 11 16 32 31 31 11 11 11 11 11 11 11 11 11 61 62 16 11 11 11 11 11 11 11 11 11 11 11 11 11 11 16 11 11 17 11 80 11 11 11 11 11 11 11 11 11 11 11
11 11 11 11 11 11 11 17 11 11 16 11 11 11 11 11 11 11 11 11 11 11 16 33 33 13 13 13 13 13 13 13 13 13 13 13 13 18 11 11 11 11 12 13 13 63 13 13 13 13 13 13 18 11 11 19 13 81 14 11 11 11 11 11 11 11 11 11 11
11 11 11 11 11 11 11 17 11 11 16 11 11 11 11 11 11 11 11 11 11 11 34 20 20 20 20 20 20 20 57 20 20 20 20 21 20 20 11 11 11 11 16 20 20 64 20 20 20 20 77 20 20 11 11 20 20 69 37 11 11 11 11 11 11 11 11 11 11
11 11 11 11 11 11 11 17 11 11 16 11 11 11 11 11 11 11 11 11 11 11 11 11 11 11 11 11 11 11 11 11 11 11 11 11 11 11 11 11 11 11 16 65 11 11 11 11 11 11 11 11 11 11 11 11 60 70 16 11 11 11 11 11 11 11 11 11 11
11 11 11 11 11 11 11 17 11 11 16 11 11 11 11 11 11 11 11 11 11 11 11 11 11 11 11 11 11 11 11 11 11 11 11 11 11 11 11 11 11 11 16 66 11 11 11 11 11 11 11 11 11 11 11 59 60 11 16 11 11 11 11 11 11 11 11 11 11
11 11 11 11 11 11 11 17 11 11 16 11 11 11 11 11 11 11 11 11 11 11 11 11 11 11 11 11 11 11 11 11 11 11 11 11 11 11 11 11 11 11 16 11 11 11 11 11 71 72 73 11 11 11 11 61 62 11 16 11 11 11 11 11 11 11 11 11 11
11 11 11 11 11 11 11 17 11 11 16 11 11 11 11 11 11 11 11 11 11 11 11 11 11 11 11 11 11 11 11 11 11 11 11 11 11 11 11 11 11 11 16 11 11 11 11 11 74 75 76 11 11 11 11 11 11 11 16 11 11 11 11 11 11 11 11 11 11
11 11 11 11 11 11 11 17 11 11 16 11 11 11 11 11 11 11 11 11 11 11 11 11 11 11 11 11 11 11 11 11 11 11 11 11 11 11 11 11 11 11 16 11 11 11 11 11 11 11 11 11 11 11 11 11 11 11 16 11 11 11 11 11 11 11 11 11 11
11 11 11 11 11 13 13 17 11 11 16 13 14 11 11 11 11 11 12 13 13 13 13 13 13 13 13 13 14 11 11 11 11 11 11 11 11 11 11 11 11 11 16 11 11 11 11 11 11 11 11 11 11 11 11 11 11 11 16 11 11 11 11 11 11 11 11 11 11
11 11 11 11 11 36 21 35 11 11 34 39 37 11 11 11 11 11 16 40 20 20 25 22 20 20 20 20 37 11 11 11 11 11 11 11 11 11 11 11 11 11 16 11 11 11 11 13 13 13 13 13 13 13 13 13 13 13 18 11 11 11 11 11 11 11 11 11 11
11 11 11 11 11 17 11 11 11 11 11 11 16 13 13 13 13 13 18 41 11 11 11 11 11 11 11 11 16 13 13 13 13 13 13 13 13 13 13 13 13 13 18 11 11 11 11 36 20 20 20 22 20 20 20 20 20 20 20 11 11 11 11 11 11 11 11 11 11
11 11 11 11 11 17 11 11 11 11 11 11 34 20 20 20 20 20 20 11 11 11 11 11 11 11 11 11 34 20 20 20 20 20 20 20 20 20 20 20 20 20 20 11 11 11 11 17 11 11 11 11 11 11 11 11 11 11 11 11 11 11 11 11 11 11 11 11 11
11 11 11 11 11 17 11 11 11 11 11 11 11 11 11 11 11 11 11 11 11 11 42 43 44 45 11 11 11 11 11 11 11 11 11 11 11 11 11 11 11 11 11 11 11 11 11 17 11 11 11 11 11 11 11 11 11 11 11 11 11 11 11 11 11 11 11 11 11
11 11 11 11 11 17 11 11 11 11 11 11 12 13 13 13 13 13 14 11 11 11 46 47 48 49 11 11 12 13 13 13 13 13 13 13 13 13 13 13 13 13 14 11 11 11 11 17 11 11 11 11 11 11 11 11 11 11 11 11 11 11 11 11 11 11 11 11 11
11 11 11 11 11 17 11 11 11 11 11 11 16 20 20 20 20 20 37 11 11 11 50 51 52 53 11 11 16 20 20 20 20 20 20 20 20 20 20 20 21 20 37 13 13 13 13 17 11 11 11 11 11 11 11 11 11 11 11 11 11 11 11 11 11 11 11 11 11
11 11 11 11 11 19 13 13 13 13 13 13 18 11 11 11 11 11 16 13 13 13 13 13 13 13 13 13 18 11 11 11 11 11 11 11 11 11 11 11 11 11 34 67 20 20 20 35 11 11 11 11 11 11 11 11 11 11 11 11 11 11 11 11 11 11 11 11 11
11 11 11 11 11 20 20 20 20 20 20 20 20 11 11 11 11 11 34 20 20 22 20 20 20 20 20 20 20 11 11 11 11 11 11 11 11 11 11 11 11 11 11 11 11 11 11 11 11 11 11 11 11 11 11 11 11 11 11 11 11 11 11 11 11 11 11 11 11
11 11 11 11 11 11 11 11 11 11 11 11 11 11 11 11 11 11 11 11 11 11 11 11 11 11 11 11 11 11 11 11 11 11 11 11 11 11 11 11 11 11 11 11 11 11 11 11 11 11 11 11 11 11 11 11 11 11 11 11 11 11 11 11 11 11 11 11 11